11111111
10C000E1
1P00C001
11111111
