111111111111111111
1000000000000000E1
1P000000000000C001
111111111111111111
