11111111
100000E1
1P00C001
11111111
