11111111
10C000E1
1P000001
11111111
